Sober up - AJR
Human - Rag'n'Bone Man
Unforgettable - Thomas Rhett
Reminding Me - Shawn Hook
So Much More Than This - Grace VanderWaal
Honest - The Chainsmokers
Wish I knew You - The Revivalists
Streetlights on Mars - Jackson Penn
Raise Hell - Dorothy
Help Our Souls - NIHILS
We Go Down - Krewella
All On Me - Devin Dawson
Psychopath - Charlotte Lawrence
Broken Halos - Chris Stapleton
So Tied Up - Cold War Kids
Man on a Mission - Oh the Larceny
You Can't Always Get What You Want - The Rolling Stones
Remember The Name - Fort Minor
How You Remind Me - Nickelback
Till I Collapse - Eminem
Broken People - Logic
Home - Machine Gun Kelly
Beautiful - Huntar
Fire - Barns Courtney
Someone to Stay - Vancouver Sleep Clinic
Waves - Dean Lewis
October - Gray
That's Okay - Riley Whisler
PDA - Scott Helman
Lie - Jay Putty
Milestone - Joey Kidney
Keep me in Your Heart - Warren Zevon
Bruises - Lewis Capaldi
Fight for It - Lucy Spraggan